0 - co , 1- cay , 2 - nuoc , 3 - go, 4 -cau , 5- dat 

01203000001111111111    
55455000000000100000	
01205000001101330111
01203000000101350002
00205100000001151104
35455555555555550112
10201112222222242222
22222214444444444442
22222222222222242222
22222222222222242222
22222222222222242222
35455555555555550112
00205100000001151104
01203000000101350002
01205000001101330111
55455000000000100000
20000020101020000002
20000022222220000002
20000000000000000002