55000666666666666666
55506666666666666662
55000666666666110006
05000066666610000000
05006666666610355550
64666666666610053350
64666666666610353350
64666666666660055550
64626662666666005500
64660006006622605500
05600000000622605500
05000110016222664466
05000000010622222222
05550101000622222222
00555000000622222222
00000000000422222222
00100051001622222222
00100550006222222222
00003500000622222222
00000300000622222222

