55000622222222222222
55506222222222666662
55000622222266110006
05000062222610000000
05006622222610355550
64662222222610053350
64622222222610353350
64622222222660055550
64626662662626005500
64660006006622605500
05600000000622605500
05000110016222664466
05000000010622222222
05550101000622222222
00555000000622222222
00000000000422222222
00100051001622222222
00100550006222222222
00003500000622222222
00000300000622222222

