10012222215311222222
15104444403000222222
15304444405511222222
10502222200011222222
10002222200330222222
10012222200030222222
22222000200000222222
22222015205000222222
22222013222442222222
22222000222442222222
22222000222442222222
22222222222442222222
00000000100000032222
10101000000000032222
10003300055000032222
10002255055000054492
10002255000000054492
10100005000000032222
10000000000000032222
11111111111111132222