22222222222222222222
22222222222222222201
22200220400002222100
22000000400000222350
22000000400000022551
22105500405500022000
22005000405530225510
22010100400302222230
22000000400000022223
22000000400000022222
22000000400220022222
22010010400220022222
22000000200000022222
22005102200000022222
22233022200000222222
22222222222222222222
22522222222222222222
03022222222222222222
05022222222222222222
10322222222222222222