1 2 3 1 4 2 2 2 2 2 2 2 2 2 2 2     
5 5 6 5 5 1 1 1 1 1 2 1 1 1 1 1
1 2 3 1 5 1 2 2 1 2 4 4 1 2 2 2
1 2 3 1 4 1 1 2 1 2 4 5 1 1 1 3
1 1 3 1 5 2 1 1 1 2 2 5 2 2 1 6
4 5 6 5 5 5 4 4 5 5 5 5 1 2 2 3
2 1 3 1 2 3 3 3 3 3 3 7 3 3 3 3
3 3 3 3 3 3 6 6 6 6 6 7 6 6 6 3
3 3 3 3 3 3 3 3 3 3 3 7 3 3 3 3